11111111111
12100111001
10000010011
10111000111
10001011011
11001011001
11100000031
11111111111
